4 4 4 4 4 4 4 4 4 4 4 4 4 4 4 4 4 4 4 4 4 4 4 4 4 4 4 4 4 4 4 4 4 4 4 4 4 4 4 4 4 4 4 4 4 4 4 4 4 4 4 4 4 4 4 4 4 4 4 4 4 4 4 4 4 4 4 4 4 4 4 4 
4 3 3 3 3 3 3 3 3 3 3 3 3 3 3 3 3 3 3 3 4 3 3 3 3 3 3 3 4 3 3 3 4 3 3 3 3 3 3 3 3 3 3 3 3 3 3 3 4 3 3 3 3 3 3 3 4 3 3 3 4 3 3 3 3 3 3 3 4 3 3 1 
4 3 4 4 4 4 4 4 4 3 4 4 4 4 4 4 4 4 4 3 4 4 4 4 4 3 4 3 4 3 4 3 4 3 4 4 4 4 4 4 4 3 4 3 4 4 4 4 4 3 4 4 4 3 4 3 4 3 4 3 4 3 4 4 4 4 4 3 4 4 4 3 
4 3 3 3 4 3 3 3 4 3 3 3 4 3 3 3 4 3 3 3 4 100 3 3 3 3 4 3 3 3 4 3 4 3 4 3 3 3 3 3 4 3 4 3 4 3 3 3 3 3 4 3 3 3 4 3 3 3 4 3 3 3 4 3 3 3 3 3 4 3 3 3 
4 4 4 3 4 3 4 3 4 4 4 3 4 3 4 4 4 3 4 4 4 3 4 4 4 3 4 4 4 4 4 4 4 3 4 3 4 4 4 3 4 3 4 4 4 3 4 4 4 4 4 3 4 4 4 4 4 3 4 4 4 4 4 4 4 4 4 3 4 3 4 3 
4 3 4 3 4 3 4 3 4 3 3 3 4 3 3 3 3 3 3 3 3 3 4 3 3 3 4 3 3 3 4 3 3 3 4 3 4 3 4 3 4 3 4 100 3 3 3 3 4 3 3 3 4 3 3 3 4 3 4 3 3 3 3 3 3 3 4 3 4 3 4 3 
4 3 4 3 4 3 4 3 4 3 4 4 4 3 4 4 4 4 4 4 4 4 4 3 4 4 4 3 4 100 4 3 4 4 4 3 4 3 4 3 4 3 4 3 4 4 4 4 4 3 4 4 4 3 4 4 4 3 4 3 4 4 4 4 4 3 4 3 4 3 4 3 
4 3 3 3 4 3 4 3 3 3 4 3 4 3 3 3 3 3 4 3 3 3 4 3 4 3 3 3 4 3 4 3 3 3 4 3 4 3 3 3 4 3 3 3 4 3 3 3 4 3 3 3 4 3 3 3 4 3 4 3 4 3 3 100 4 3 4 3 3 3 4 3 
4 3 4 4 4 3 4 4 4 4 4 3 4 4 4 3 4 4 4 3 4 3 4 4 4 3 4 4 4 3 4 4 4 3 4 3 4 4 4 3 4 4 4 4 4 3 4 3 4 3 4 3 4 4 4 3 4 3 4 3 4 3 4 3 4 3 4 4 4 4 4 3 
4 3 4 100 3 3 4 3 3 3 3 3 3 3 4 3 4 3 3 3 4 3 3 3 4 3 3 3 4 3 4 3 3 3 4 3 3 3 4 3 4 3 3 3 3 3 4 3 4 3 4 3 3 3 4 3 3 3 4 3 4 3 4 3 4 3 3 3 3 3 4 3 
4 4 4 3 4 4 4 4 4 4 4 3 4 3 4 3 4 3 4 4 4 4 4 3 4 4 4 3 4 3 4 3 4 4 4 4 4 3 4 3 4 3 4 4 4 4 4 3 4 3 4 4 4 3 4 4 4 4 4 3 4 4 4 3 4 4 4 4 4 3 4 3 
4 3 3 3 4 3 3 3 3 3 4 3 4 3 3 3 4 3 4 3 3 3 4 3 3 3 4 3 4 3 4 3 4 3 4 3 3 3 4 3 3 3 4 3 3 3 3 3 4 3 3 3 4 3 4 3 3 3 3 3 4 3 3 3 3 3 3 3 4 3 4 3 
4 3 4 3 4 3 4 4 4 3 4 4 4 3 4 4 4 3 4 3 4 3 4 3 4 4 4 3 4 3 4 3 4 3 4 4 4 4 4 4 4 4 4 3 4 4 4 4 4 4 4 3 4 3 4 3 4 4 4 4 4 3 4 4 4 4 4 3 4 3 4 3 
4 3 4 3 4 3 3 3 4 3 3 3 4 3 4 3 3 3 4 3 4 3 4 3 3 3 4 3 4 3 4 3 4 3 3 3 4 3 3 3 3 3 4 3 4 3 3 3 3 3 4 3 4 3 3 3 4 3 3 3 4 3 4 3 3 3 4 3 4 3 4 3 
4 3 4 4 4 4 4 3 4 4 4 3 4 3 4 3 4 4 4 3 4 3 4 3 4 3 4 3 4 3 4 3 4 3 4 3 4 3 4 3 4 3 4 3 4 4 4 4 4 3 4 3 4 4 4 4 4 3 4 3 4 3 4 3 4 3 4 3 4 3 4 3 
4 3 3 3 4 3 3 3 3 3 4 3 4 3 4 100 4 3 3 3 4 3 4 3 4 3 4 3 4 3 3 3 4 3 4 3 3 3 4 3 4 3 4 3 3 3 3 3 4 3 3 3 3 3 3 3 3 3 4 3 3 3 4 3 4 3 3 3 4 3 4 3 
4 3 4 3 4 3 4 4 4 4 4 3 4 4 4 3 4 3 4 4 4 3 4 4 4 3 4 3 4 4 4 4 4 4 4 4 4 4 4 3 4 4 4 4 4 4 4 3 4 4 4 4 4 4 4 4 4 4 4 4 4 4 4 4 4 4 4 4 4 3 4 3 
4 3 4 3 4 3 4 3 3 3 3 3 4 3 3 3 4 3 4 3 3 3 3 100 3 3 4 3 4 3 3 3 3 3 3 3 3 3 4 3 4 3 3 3 3 3 4 3 4 3 3 3 3 3 4 3 3 3 4 3 3 3 3 3 3 3 4 3 3 3 4 3 
4 4 4 3 4 3 4 3 4 4 4 3 4 3 4 4 4 3 4 4 4 4 4 4 4 4 4 3 4 3 4 4 4 3 4 4 4 3 4 3 4 3 4 4 4 3 4 3 4 3 4 4 4 3 4 3 4 3 4 3 4 4 4 4 4 3 4 3 4 4 4 4 
4 3 3 3 4 3 4 3 3 3 4 3 4 3 3 3 4 3 3 3 3 3 3 3 3 3 4 3 4 3 3 3 4 3 4 3 3 3 4 3 3 3 3 3 4 3 4 3 4 3 4 3 4 3 3 3 4 3 4 3 4 3 3 3 3 3 4 3 3 3 3 3 
4 3 4 3 4 3 4 4 4 3 4 3 4 4 4 3 4 4 4 4 4 4 4 4 4 3 4 3 4 4 4 4 4 3 4 3 4 4 4 3 4 4 4 4 4 3 4 3 4 3 4 3 4 4 4 4 4 3 4 3 4 4 4 3 4 4 4 4 4 4 4 3 
4 3 4 3 4 3 3 3 4 3 4 3 3 3 4 3 3 3 4 100 3 3 4 3 3 3 4 3 4 3 3 3 4 3 4 3 3 3 4 3 4 3 3 3 3 3 4 3 3 3 4 3 3 3 3 100 3 3 4 3 3 3 4 3 100 3 3 3 3 3 4 3 
4 3 4 4 4 4 4 3 4 3 4 4 4 4 4 4 4 3 4 4 4 3 4 3 4 4 4 3 4 3 4 3 4 3 4 4 4 3 4 4 4 3 4 4 4 3 4 4 4 4 4 3 4 4 4 4 4 4 4 4 4 3 4 4 4 4 4 4 4 3 4 3 
4 3 3 3 3 3 3 3 4 3 3 3 3 3 3 3 3 3 3 3 3 3 4 3 3 3 3 3 3 3 4 3 3 3 4 3 3 3 3 3 3 3 4 3 3 3 3 3 3 3 4 3 3 3 3 3 3 3 3 3 3 3 4 3 3 3 3 3 3 3 3 3 
